"filename", "language", "Makefile", "Markdown", "C", "C++", "comment", "blank", "total"
"/home/ehosta/Documents/42-minishell/CONTRIBUTING.md", "Markdown", 0, 67, 0, 0, 0, 28, 95
"/home/ehosta/Documents/42-minishell/Makefile", "Makefile", 93, 0, 0, 0, 18, 41, 152
"/home/ehosta/Documents/42-minishell/README.md", "Markdown", 0, 14, 0, 0, 0, 6, 20
"/home/ehosta/Documents/42-minishell/include/minishell.h", "C", 0, 0, 261, 0, 157, 43, 461
"/home/ehosta/Documents/42-minishell/lib/Makefile", "Makefile", 38, 0, 0, 0, 11, 11, 60
"/home/ehosta/Documents/42-minishell/lib/README.md", "Markdown", 0, 4, 0, 0, 0, 2, 6
"/home/ehosta/Documents/42-minishell/lib/include/ft_array.h", "C++", 0, 0, 0, 37, 11, 6, 54
"/home/ehosta/Documents/42-minishell/lib/include/ft_base.h", "C++", 0, 0, 0, 33, 11, 6, 50
"/home/ehosta/Documents/42-minishell/lib/include/ft_fd.h", "C++", 0, 0, 0, 11, 61, 10, 82
"/home/ehosta/Documents/42-minishell/lib/include/ft_free.h", "C++", 0, 0, 0, 7, 11, 4, 22
"/home/ehosta/Documents/42-minishell/lib/include/ft_is.h", "C++", 0, 0, 0, 12, 38, 12, 62
"/home/ehosta/Documents/42-minishell/lib/include/ft_lst.h", "C++", 0, 0, 0, 19, 11, 6, 36
"/home/ehosta/Documents/42-minishell/lib/include/ft_math.h", "C++", 0, 0, 0, 6, 11, 3, 20
"/home/ehosta/Documents/42-minishell/lib/include/ft_mem.h", "C", 0, 0, 12, 0, 15, 5, 32
"/home/ehosta/Documents/42-minishell/lib/include/ft_misc.h", "C++", 0, 0, 0, 4, 11, 3, 18
"/home/ehosta/Documents/42-minishell/lib/include/ft_printf.h", "C++", 0, 0, 0, 10, 11, 6, 27
"/home/ehosta/Documents/42-minishell/lib/include/ft_str.h", "C++", 0, 0, 0, 21, 11, 5, 37
"/home/ehosta/Documents/42-minishell/lib/include/ft_to.h", "C++", 0, 0, 0, 11, 11, 5, 27
"/home/ehosta/Documents/42-minishell/lib/include/get_next_line.h", "C++", 0, 0, 0, 12, 19, 5, 36
"/home/ehosta/Documents/42-minishell/lib/include/libft.h", "C", 0, 0, 16, 0, 11, 4, 31
"/home/ehosta/Documents/42-minishell/lib/src/array/ft_array_clear.c", "C", 0, 0, 14, 0, 11, 3, 28
"/home/ehosta/Documents/42-minishell/lib/src/array/ft_array_cpy.c", "C", 0, 0, 49, 0, 11, 9, 69
"/home/ehosta/Documents/42-minishell/lib/src/array/ft_array_fill.c", "C", 0, 0, 21, 0, 11, 7, 39
"/home/ehosta/Documents/42-minishell/lib/src/array/ft_array_getmax.c", "C", 0, 0, 16, 0, 11, 4, 31
"/home/ehosta/Documents/42-minishell/lib/src/array/ft_array_getmin.c", "C", 0, 0, 16, 0, 11, 4, 31
"/home/ehosta/Documents/42-minishell/lib/src/array/ft_array_getpos.c", "C", 0, 0, 14, 0, 11, 4, 29
"/home/ehosta/Documents/42-minishell/lib/src/array/ft_array_getsorted.c", "C", 0, 0, 27, 0, 11, 4, 42
"/home/ehosta/Documents/42-minishell/lib/src/array/ft_array_getval.c", "C", 0, 0, 20, 0, 11, 4, 35
"/home/ehosta/Documents/42-minishell/lib/src/array/ft_array_issorted.c", "C", 0, 0, 13, 0, 11, 4, 28
"/home/ehosta/Documents/42-minishell/lib/src/array/ft_array_new.c", "C", 0, 0, 22, 0, 11, 4, 37
"/home/ehosta/Documents/42-minishell/lib/src/array/ft_array_popint.c", "C", 0, 0, 23, 0, 11, 4, 38
"/home/ehosta/Documents/42-minishell/lib/src/array/ft_array_posdist.c", "C", 0, 0, 21, 0, 11, 4, 36
"/home/ehosta/Documents/42-minishell/lib/src/array/ft_array_prints.c", "C", 0, 0, 51, 0, 11, 8, 70
"/home/ehosta/Documents/42-minishell/lib/src/array/ft_array_pushint.c", "C", 0, 0, 18, 0, 11, 4, 33
"/home/ehosta/Documents/42-minishell/lib/src/fd/ft_putchar_fd.c", "C", 0, 0, 5, 0, 11, 3, 19
"/home/ehosta/Documents/42-minishell/lib/src/fd/ft_putendl_fd.c", "C", 0, 0, 13, 0, 11, 4, 28
"/home/ehosta/Documents/42-minishell/lib/src/fd/ft_putnbr_base_fd.c", "C", 0, 0, 24, 0, 11, 4, 39
"/home/ehosta/Documents/42-minishell/lib/src/fd/ft_putnbr_fd.c", "C", 0, 0, 5, 0, 11, 3, 19
"/home/ehosta/Documents/42-minishell/lib/src/fd/ft_putptr_fd.c", "C", 0, 0, 17, 0, 11, 4, 32
"/home/ehosta/Documents/42-minishell/lib/src/fd/ft_putstr_fd.c", "C", 0, 0, 5, 0, 11, 3, 19
"/home/ehosta/Documents/42-minishell/lib/src/free/ft_free_inttab.c", "C", 0, 0, 6, 0, 11, 3, 20
"/home/ehosta/Documents/42-minishell/lib/src/free/ft_free_str.c", "C", 0, 0, 6, 0, 11, 3, 20
"/home/ehosta/Documents/42-minishell/lib/src/free/ft_free_strtab.c", "C", 0, 0, 10, 0, 11, 4, 25
"/home/ehosta/Documents/42-minishell/lib/src/get_next_line/get_next_line.c", "C", 0, 0, 87, 0, 11, 11, 109
"/home/ehosta/Documents/42-minishell/lib/src/is/ft_isalnum.c", "C", 0, 0, 5, 0, 11, 3, 19
"/home/ehosta/Documents/42-minishell/lib/src/is/ft_isalpha.c", "C", 0, 0, 5, 0, 11, 3, 19
"/home/ehosta/Documents/42-minishell/lib/src/is/ft_isascii.c", "C", 0, 0, 5, 0, 11, 3, 19
"/home/ehosta/Documents/42-minishell/lib/src/is/ft_isdigit.c", "C", 0, 0, 5, 0, 11, 3, 19
"/home/ehosta/Documents/42-minishell/lib/src/is/ft_isincharset.c", "C", 0, 0, 11, 0, 11, 3, 25
"/home/ehosta/Documents/42-minishell/lib/src/is/ft_isprint.c", "C", 0, 0, 5, 0, 11, 3, 19
"/home/ehosta/Documents/42-minishell/lib/src/is/ft_issorted.c", "C", 0, 0, 9, 0, 11, 4, 24
"/home/ehosta/Documents/42-minishell/lib/src/is/ft_isspace.c", "C", 0, 0, 8, 0, 11, 3, 22
"/home/ehosta/Documents/42-minishell/lib/src/lst/ft_lstadd_back.c", "C", 0, 0, 8, 0, 11, 3, 22
"/home/ehosta/Documents/42-minishell/lib/src/lst/ft_lstadd_front.c", "C", 0, 0, 8, 0, 11, 3, 22
"/home/ehosta/Documents/42-minishell/lib/src/lst/ft_lstclear.c", "C", 0, 0, 14, 0, 11, 4, 29
"/home/ehosta/Documents/42-minishell/lib/src/lst/ft_lstdelone.c", "C", 0, 0, 9, 0, 11, 3, 23
"/home/ehosta/Documents/42-minishell/lib/src/lst/ft_lstiter.c", "C", 0, 0, 11, 0, 11, 3, 25
"/home/ehosta/Documents/42-minishell/lib/src/lst/ft_lstlast.c", "C", 0, 0, 9, 0, 11, 3, 23
"/home/ehosta/Documents/42-minishell/lib/src/lst/ft_lstmap.c", "C", 0, 0, 24, 0, 11, 4, 39
"/home/ehosta/Documents/42-minishell/lib/src/lst/ft_lstnew.c", "C", 0, 0, 11, 0, 11, 4, 26
"/home/ehosta/Documents/42-minishell/lib/src/lst/ft_lstsize.c", "C", 0, 0, 19, 0, 11, 4, 34
"/home/ehosta/Documents/42-minishell/lib/src/math/ft_abs.c", "C", 0, 0, 5, 0, 11, 3, 19
"/home/ehosta/Documents/42-minishell/lib/src/math/ft_sign.c", "C", 0, 0, 5, 0, 11, 3, 19
"/home/ehosta/Documents/42-minishell/lib/src/math/ft_sqrt.c", "C", 0, 0, 8, 0, 11, 3, 22
"/home/ehosta/Documents/42-minishell/lib/src/mem/ft_bzero.c", "C", 0, 0, 11, 0, 11, 4, 26
"/home/ehosta/Documents/42-minishell/lib/src/mem/ft_calloc.c", "C", 0, 0, 14, 0, 11, 4, 29
"/home/ehosta/Documents/42-minishell/lib/src/mem/ft_memalloc.c", "C", 0, 0, 10, 0, 11, 5, 26
"/home/ehosta/Documents/42-minishell/lib/src/mem/ft_memchr.c", "C", 0, 0, 13, 0, 11, 4, 28
"/home/ehosta/Documents/42-minishell/lib/src/mem/ft_memcmp.c", "C", 0, 0, 15, 0, 11, 4, 30
"/home/ehosta/Documents/42-minishell/lib/src/mem/ft_memcpy.c", "C", 0, 0, 18, 0, 11, 4, 33
"/home/ehosta/Documents/42-minishell/lib/src/mem/ft_memmove.c", "C", 0, 0, 19, 0, 11, 4, 34
"/home/ehosta/Documents/42-minishell/lib/src/mem/ft_memset.c", "C", 0, 0, 12, 0, 11, 4, 27
"/home/ehosta/Documents/42-minishell/lib/src/misc/ft_selection_sort.c", "C", 0, 0, 25, 0, 11, 4, 40
"/home/ehosta/Documents/42-minishell/lib/src/printf/ft_printf.c", "C", 0, 0, 92, 0, 11, 12, 115
"/home/ehosta/Documents/42-minishell/lib/src/str/ft_split.c", "C", 0, 0, 85, 0, 11, 10, 106
"/home/ehosta/Documents/42-minishell/lib/src/str/ft_strchr.c", "C", 0, 0, 15, 0, 11, 4, 30
"/home/ehosta/Documents/42-minishell/lib/src/str/ft_strdup.c", "C", 0, 0, 19, 0, 11, 4, 34
"/home/ehosta/Documents/42-minishell/lib/src/str/ft_striteri.c", "C", 0, 0, 13, 0, 11, 4, 28
"/home/ehosta/Documents/42-minishell/lib/src/str/ft_strjoin.c", "C", 0, 0, 24, 0, 11, 4, 39
"/home/ehosta/Documents/42-minishell/lib/src/str/ft_strlcat.c", "C", 0, 0, 21, 0, 11, 4, 36
"/home/ehosta/Documents/42-minishell/lib/src/str/ft_strlcpy.c", "C", 0, 0, 20, 0, 11, 4, 35
"/home/ehosta/Documents/42-minishell/lib/src/str/ft_strlen.c", "C", 0, 0, 11, 0, 11, 4, 26
"/home/ehosta/Documents/42-minishell/lib/src/str/ft_strlenc.c", "C", 0, 0, 11, 0, 11, 4, 26
"/home/ehosta/Documents/42-minishell/lib/src/str/ft_strmapi.c", "C", 0, 0, 19, 0, 11, 4, 34
"/home/ehosta/Documents/42-minishell/lib/src/str/ft_strncmp.c", "C", 0, 0, 23, 0, 11, 3, 37
"/home/ehosta/Documents/42-minishell/lib/src/str/ft_strnstr.c", "C", 0, 0, 26, 0, 11, 4, 41
"/home/ehosta/Documents/42-minishell/lib/src/str/ft_strrchr.c", "C", 0, 0, 12, 0, 11, 4, 27
"/home/ehosta/Documents/42-minishell/lib/src/str/ft_strtrim.c", "C", 0, 0, 35, 0, 11, 7, 53
"/home/ehosta/Documents/42-minishell/lib/src/str/ft_substr.c", "C", 0, 0, 34, 0, 11, 7, 52
"/home/ehosta/Documents/42-minishell/lib/src/to/ft_atoi.c", "C", 0, 0, 26, 0, 11, 4, 41
"/home/ehosta/Documents/42-minishell/lib/src/to/ft_itoa.c", "C", 0, 0, 63, 0, 11, 9, 83
"/home/ehosta/Documents/42-minishell/lib/src/to/ft_tolower.c", "C", 0, 0, 7, 0, 11, 3, 21
"/home/ehosta/Documents/42-minishell/lib/src/to/ft_toupper.c", "C", 0, 0, 7, 0, 11, 3, 21
"/home/ehosta/Documents/42-minishell/lib/variables.mk", "Makefile", 127, 0, 0, 0, 11, 4, 142
"/home/ehosta/Documents/42-minishell/src/builtins/builtin_cd.c", "C", 0, 0, 63, 0, 11, 8, 82
"/home/ehosta/Documents/42-minishell/src/builtins/builtin_echo.c", "C", 0, 0, 18, 0, 11, 4, 33
"/home/ehosta/Documents/42-minishell/src/builtins/builtin_env.c", "C", 0, 0, 53, 0, 11, 8, 72
"/home/ehosta/Documents/42-minishell/src/builtins/builtin_exit.c", "C", 0, 0, 19, 0, 11, 4, 34
"/home/ehosta/Documents/42-minishell/src/builtins/builtin_export.c", "C", 0, 0, 7, 0, 11, 3, 21
"/home/ehosta/Documents/42-minishell/src/builtins/builtin_pwd.c", "C", 0, 0, 21, 0, 11, 4, 36
"/home/ehosta/Documents/42-minishell/src/builtins/builtin_unset.c", "C", 0, 0, 44, 0, 11, 6, 61
"/home/ehosta/Documents/42-minishell/src/env_manager/create_env.c", "C", 0, 0, 90, 0, 11, 10, 111
"/home/ehosta/Documents/42-minishell/src/env_manager/env_to_strlst.c", "C", 0, 0, 41, 0, 11, 7, 59
"/home/ehosta/Documents/42-minishell/src/env_manager/get_var.c", "C", 0, 0, 15, 0, 11, 4, 30
"/home/ehosta/Documents/42-minishell/src/errors/error_handler.c", "C", 0, 0, 7, 0, 11, 3, 21
"/home/ehosta/Documents/42-minishell/src/errors/puterr.c", "C", 0, 0, 21, 0, 11, 3, 35
"/home/ehosta/Documents/42-minishell/src/exec/heredoc/heredoc.c", "C", 0, 0, 14, 0, 11, 4, 29
"/home/ehosta/Documents/42-minishell/src/exec/init/create_cmd.c", "C", 0, 0, 81, 0, 11, 9, 101
"/home/ehosta/Documents/42-minishell/src/exec/init/create_redirect.c", "C", 0, 0, 62, 0, 11, 8, 81
"/home/ehosta/Documents/42-minishell/src/exec/init/redirect_manager.c", "C", 0, 0, 82, 0, 11, 9, 102
"/home/ehosta/Documents/42-minishell/src/exec/process/exec.c", "C", 0, 0, 98, 0, 11, 6, 115
"/home/ehosta/Documents/42-minishell/src/exec/process/exec_utils.c", "C", 0, 0, 46, 0, 11, 7, 64
"/home/ehosta/Documents/42-minishell/src/exec/process/execute_builtin.c", "C", 0, 0, 9, 0, 0, 4, 13
"/home/ehosta/Documents/42-minishell/src/exec/process/execute_from_path.c", "C", 0, 0, 54, 0, 11, 5, 70
"/home/ehosta/Documents/42-minishell/src/exec/timeline/create_child.c", "C", 0, 0, 22, 0, 0, 3, 25
"/home/ehosta/Documents/42-minishell/src/exec/timeline/create_cmd_pipe.c", "C", 0, 0, 71, 0, 0, 6, 77
"/home/ehosta/Documents/42-minishell/src/exec/timeline/fd_manager.c", "C", 0, 0, 85, 0, 0, 7, 92
"/home/ehosta/Documents/42-minishell/src/exec/timeline/load_pipeline_params.c", "C", 0, 0, 39, 0, 0, 5, 44
"/home/ehosta/Documents/42-minishell/src/exec/timeline/restore_std.c", "C", 0, 0, 1, 0, 0, 3, 4
"/home/ehosta/Documents/42-minishell/src/main.c", "C", 0, 0, 174, 0, 22, 16, 212
"/home/ehosta/Documents/42-minishell/src/memory/free_cmds.c", "C", 0, 0, 57, 0, 11, 8, 76
"/home/ehosta/Documents/42-minishell/src/memory/free_env.c", "C", 0, 0, 24, 0, 11, 4, 39
"/home/ehosta/Documents/42-minishell/src/misc/print_cmds.c", "C", 0, 0, 145, 0, 11, 6, 162
"/home/ehosta/Documents/42-minishell/src/misc/show_prompt.c", "C", 0, 0, 62, 0, 11, 11, 84
"/home/ehosta/Documents/42-minishell/src/misc/signals.c", "C", 0, 0, 23, 0, 27, 5, 55
"/home/ehosta/Documents/42-minishell/src/parsing/lexer/lexer.c", "C", 0, 0, 164, 0, 23, 19, 206
"/home/ehosta/Documents/42-minishell/src/parsing/lexer/lexer_parse.c", "C", 0, 0, 62, 0, 11, 9, 82
"/home/ehosta/Documents/42-minishell/src/parsing/lexer/lexer_utils.c", "C", 0, 0, 23, 0, 12, 5, 40
"/home/ehosta/Documents/42-minishell/src/parsing/tokenizer/expand_tokens.c", "C", 0, 0, 210, 0, 26, 19, 255
"/home/ehosta/Documents/42-minishell/src/parsing/tokenizer/fragments.c", "C", 0, 0, 32, 0, 20, 7, 59
"/home/ehosta/Documents/42-minishell/src/parsing/tokenizer/token_lexer.c", "C", 0, 0, 47, 0, 11, 8, 66
"/home/ehosta/Documents/42-minishell/src/parsing/tokenizer/token_list.c", "C", 0, 0, 78, 0, 25, 8, 111
"/home/ehosta/Documents/42-minishell/src/utils/empty_tab.c", "C", 0, 0, 6, 0, 11, 4, 21
"/home/ehosta/Documents/42-minishell/src/utils/ft_sprintf.c", "C", 0, 0, 75, 0, 11, 11, 97
"/home/ehosta/Documents/42-minishell/src/utils/parsing/count_arg_words.c", "C", 0, 0, 17, 0, 11, 4, 32
"/home/ehosta/Documents/42-minishell/src/utils/parsing/free_str_return_null.c", "C", 0, 0, 6, 0, 11, 3, 20
"/home/ehosta/Documents/42-minishell/src/utils/parsing/ft_split_parser.c", "C", 0, 0, 69, 0, 11, 10, 90
"/home/ehosta/Documents/42-minishell/src/utils/parsing/ft_str_join_free.c", "C", 0, 0, 31, 0, 11, 5, 47
"/home/ehosta/Documents/42-minishell/src/utils/parsing/ft_strcmp.c", "C", 0, 0, 11, 0, 11, 4, 26
"/home/ehosta/Documents/42-minishell/src/utils/parsing/get_first_word.c", "C", 0, 0, 16, 0, 11, 4, 31
"/home/ehosta/Documents/42-minishell/src/utils/parsing/handle_is_redir_token.c", "C", 0, 0, 15, 0, 11, 3, 29
"/home/ehosta/Documents/42-minishell/src/utils/parsing/incr_on_alnum.c", "C", 0, 0, 0, 0, 0, 1, 1
"/home/ehosta/Documents/42-minishell/src/utils/parsing/is_redir.c", "C", 0, 0, 6, 0, 11, 3, 20
"/home/ehosta/Documents/42-minishell/src/utils/parsing/join_token_to_string.c", "C", 0, 0, 19, 0, 11, 4, 34
"/home/ehosta/Documents/42-minishell/src/utils/parsing/print_t_token_list.c", "C", 0, 0, 19, 0, 14, 4, 37
"/home/ehosta/Documents/42-minishell/src/utils/parsing/skip_spaces.c", "C", 0, 0, 6, 0, 11, 3, 20
"/home/ehosta/Documents/42-minishell/src/utils/parsing/token_lstsize.c", "C", 0, 0, 14, 0, 11, 4, 29
"Total", "-", 258, 85, 4150, 183, 1830, 860, 7366